##############################
#.........#.......#..........#
#.........#.......#..........#
#.........#.......#..........#
#.........#.......#..........#
#.........#.......#..........#
#.................#..........#
#.................#..........#
###############...#..........#
#.................#..........#
#.................#..........#
#.....#############..........#
#.....#......................#
#.....#......................#
#.....#......................#
#.....#......................+
#.....########...............#
#............................#
#............................#
##############################
