










                               ########
                               #......#
                               #......#
                             ###......#
                             +........#
                             ###......#
                               ########   
