########################################################################   ############################################################################ 
##                  ##              #                                  #           #      ##          ##      ##          #       #          ##      ## 
##  ##########  ##  #############   #   #########  ##############  #####   #   #####   #   #   #  ##  ##  ##  ##  #####   #   #####   #####  ##  ##  ## 
##      ##      ##          #       #   #  ##      ##          ##      #   #           #      ##  ##      ##          ##          #   #  ##      ##  ## 
##########  #############   #   #####   #  ##   #####  #############   #   #############   #####  ##################  #########   #   #   #########  ## 
##      ##          ##      #      ##      ##      ##  ##              #              ##      ##  ##      ##      ##  ##      #       #              ## 
##  ##  ##########  #####   #   #################  ##  ##  #########################   #########  ######  ##  ######  ##  #   ######################### 
##  ##   #########  ####    #    ################      ##   #######################    ########    #####      #####   ##  #    ######################## 
##  ######  ##  ##  ##  #################   #########  #############   #####   #########   #########  ######  ##  #############   #   #   #   #   ##### 
##   #  ##          ##  ##  #   #              ##  ##  ##      ##      ##             ##  ##           #      ##  ##  #   #   #       #      ##      ## 
##  ##  #################   #   #   #   #####  ##  ##  ##  ##  #####   #   #   #####   #  ######################  ##  #####   #############  ##  ##  ## 
##  ##      ##              #       #      ##          ##  ##          #   #      ##   #  ##          ##          ##      #          ##      ##  ##  ## 
##########  ##  #########################  ##############  #############   #########   #####   #####  ##  ######  #####   #########   #   #########  ## 
##          ##  ##              #       #  ##      ##  ##  ##          #   #       #          ##      ##      ##          ##      #   #   #      ##  ## 
##  ##  ######  ##  #####   #   #   #   #  ##  ##  ##  ##  ##  #########   #   #   #############   #########  #############   #   #   #   #   #  ##  ## 
##  ##  ##      ##      #   #       #      ##  ##  ##  ##      ##      #       #   #      ##              ##              #   #   #   #   #  ##      ## 
##  ######  ##########  #####################  ##  ##  ##########  ##  #########   #####   #   #########  #############   #   #   #   #   #  ########## 
##  ##      ##      ##      #           #      ##  ##      ##      ##          #       #          ##              ##  ##  #   #   #   #   #          ## 
##  ##  ##  ##  ##  ##  #   #########   #   #  ######  ##  ##  ##  #########   #####   #############  ##########  ##  ##  #   #   #   #   #########  ## 
##      ##  ##  ##  ##  #               #  ##          ##      ##  ##      #       #      ##          ##      ##      ##      #   #   #   #          ## 
##########  ##  ##  ##  #################  ######  ##############  ##  #   #########   #####   #############  #####   #############   #   ############# 
##  ##      ##  ##  ##      #              ##      ##          ##  ##  #           #      ##          ##      ##          #   #           #          ## 
##  ##  ######  ##  #####   #   #############  ######  ######  ##  ##  #########   #####  ##########  ##  ##########  #   #   #   #########  ######  ## 
##      ##      ##          #           #      ##      ##  ##  ##      #       #          ##          ##          ##  ##      #   #       #  ##      ## 
##########  ##  #########################   #####  ######  ##  #####   #   #############  ##   #################  ##  #########   #   #   #  ##  ##  ## 
##          ##                          #  ##  ##  ##      ##          #               #  ##                      ##          #   #   #   #  ##  ##  ## 
##   #####  #########################   #  ##  ##  ##  ##  #####   #####   #########   #  ##################  #############   #   #####   #####  ##  ## 
##      ##      ##      #           #      ##  ##      ##  ##              #           #  ##          ##              ##      #       #          ##  ## 
######  ######  ##  #####   #####   #########  ##########  ##  #############   #########  ##   #####  #############   ##  #########   #   ############# 
##      ##      ##              #   #          ##      ##  ##  ##          #   #          ##      ##                  ##      #       #              ## 
##  ######  #################   #   #   #   #####  ##  ##  ##  ##  #####   #####   ########################################   #   #################  ## 
##      ##      ##  ##      #   #       #          ##  ##  ##      ##  #   #       #      ##      ##      ##                  #   #                  ## 
######  ######  ##  ##  #   #   #####################  ##############  #   #   #########  ##  ##  ##  ##  ##########  #########   #   ################# 
##      ##  ##      ##  #   #   #          ##          ##      ##          #   #       #  ##  ##      ##          ##  ##          #          ##      ## 
##  ######  #####   ##  #   #   #   #   #   #   #########  ##  ######  #####   #   #   #  ##  ######  ######  ######  #####   #############  ##  ##  ## 
##  ##      ##      ##  #   #   #   #   #          ##      ##      ##  #       #   #      ##      ##      ##          ##      #           #  ##  ##  ## 
##  ##  ######  ######  #   #   #   #   #############  ##########  #####   #####   #############  ##  #################   #####   #####   #  ##  ##  ## 
##  ##  ##      ##      #       #   #   #  ##          ##      ##          #       #              ##          ##              #       #      ##  ##  ## 
##  ##  ##  ######  #############   #   #  ##   #########  ##  #############   #####   #################  ##  #####   #############   #########  ###### 
##      ##          ##              #      ##          ##  ##              #       #      ##          ##  ##  ##                      #      ##      ## 
##########  #########################################  ##  #############   #####   #####  ##  ######  ##  ######  #####################   #  ######  ## 
##      ##  ##          #       #              ##      ##  ##          #       #          ##  ##      ##      ##                          #  ##      ## 
##  ##  ######  #####   #   #   #   #########  ##  ######  #####   ##  #####################  ##  ##  ######  ##  ##  #####################  ##   ##### 
##  ##          ##      #   #       #              ##              ##                     ##  ##  ##  ##      ##  ##      #       #       #  ##      ## 
##  ##############  #####   #####################  #################################   #   #####  ######  #################   #   #   #   #########  ## 
##  ##          ##      #   #       #          ##                          #           #          ##      ##                  #   #   #              ## 
##  ##########  ######  #   #   #####   #####  ##########  #####   ##  #   #####################  ##  #########################   #   ################# 
##  ##      ##      ##      #       #   #          ##      ##      ##  #           #          ##      ##          ##          #   #          ##      ## 
##  ##  ##  ##  ##  #########   #   #   #############  ######  #########   #####   #   #   #  ##########  ######  ##  #####   #   #####   #  ##  ##  ## 
#####   ################################   ##      #####   ######      #   #    ####   #  ######   #########  ##  #####   #   #############  ##  ##  ## 
######  #################################  ##  ##  ######  ######  ##  #   #   #####   #   #####  ##########  ##  #####   #   #############   #  ##  ## 
##  ##  ##   ############    ####   #      ##  ##############   ####################################   ####   ##  ##  ##  ####################   ##  ## 
##  ##  ##  #############   #####   #   #   #  ##############  #####################################  ######  ##  #   ##  #####################  ##  ## 
#########################   ########################       #####   ##      #       #   #      ##########   ########   ##   ####   #   ########   ##  ## 
#########################   #########################  ##  ######  ##  #   #   #   #   #   #  ##########  #########   ##  #####   #   #########  ##  ## 
##   ############   ##  #####       #   #####      #########   ##  ##  #########   #   #  ##  ##      #########    #######################   ##  ###### 
##   ############   ##  #####   #   #   #####  ##  ##########  ##  ##  #########   #   #  ##   #  ##  ##########  #########################  ##  ###### 
#####   ##       #####  #   #####   ####    ########   ##  ##  ##  ##  #   #####   ####   ##########  #####   ##  ##   ####   ####################   ## 
######  ##  ##  #####   #   #####   #####  ##########  ##  ##  ##  ##  #   #####   #####  ##########  ######  ##  #   #####   #####################  ## 
##  ##  ##  #################   #   #      ##  ##   ########   ##  ##  #   ############   ##   ########################   #########        ########  ## 
##  ##  ##  #################   #   #   #   #  ##  ##########  ##  #   #   #############  ##   ########################   #########   #   #########  ## 
##      ##          ##          #   #  ##      ##  ##          ##      ##              #  ##                      ##  ##  #          ##      ##      ## 
##################  ##  #####   #   #############  ##  ##  #########################   #   #####################  #   ##  #   #########   #  ##   ##### 
##              ##  ##      #   #       #          ##  ##  ##      ##                  #                      ##      ##  ##          #   #  ##      ## 
##  ##########  ##  #####   #########   #  ##   #####  ##  ##  ######  #########################  ##  ##################  #####   #   #   #   #####  ## 
##  ##      ##  ##      #               #  ##          ##          ##      #   #                  ##      ##          ##  #   #   #   #   #          ## 
######  ##  ##  #   ##  #################   #################  ##  ##  #   #   #   #####################  ##  #####   ##  #   #   #   ################# 
##      ##  ##      ##      #       #   #      ##          ##  ##  ##  #   #       #          ##      ##  ##  ##      ##  #       #   #              ## 
##  ##  ##  #############   #   #   #   #####  ##   #####  ##  ##  ##  #   #########   #####  ##  ##  ##  ##  ##  ######  #########   #   #  ##   ##### 
######  #########################   ########   ##      ##  ######  #####   #####   #####   #####  ##  #############   ##  #       #####   #  #####   ## 
######  #########################   #########  ##  ##  ##  ######  #####   #####   #####  ######  ##  #############   ##  #   #   #####   #  ######  ## 
##   ########    ####   #       #########  ######  #########   #############   #####   #  ##  ##  ##  ##      ##   #####  #################  ##  ##  ## 
##  #########   #####   #   #   #########   #####  #########   #############   #####   #   #  ##  ##  ##  ##  ##  #####   #################  ##  ##  ## 
##  ##   #########  #####   #   #   #   #####  ##  ##   ################   #   #   #   #########  ##########  ##  ##  #########   #   #####  ##  ##  ## 
##  ##   ########   #####   #   #   #   #####   #  ##   ################   #   #   #   #########  ##########  ##  #   #########   #   #####  ##   #  ## 
##  ##      ##  ######  #############   #   #   #####      ##  #####   #################   #  ######  ##   ########################   #   ############# 
##  ##  ##  ##  ######  #############   #  ##   #####  ##  ##  ######  #################  ##   #####  ##  #########################   #   ############# 
##  ######  ##########  #   #####   #################  ##  ##  #########   #   #   ############################################   #   #########   #  ## 
##  ######  #########   #   #####   #################  ##  ##  #########   #   #   ############################################   #   #########  ##  ## 
######  ##  ##  #############   #####   #   #####################  #########   #####   #####  ##   #   #  #   ##  ##  #   #############   #########  ## 
######  ##  ##  #############   #####   #   ####################   #########   #####   #####  ##  ##  ##  ##  #   ##  ##  #############   #########  ## 
##   #####  ##  #############   #   #   #####  ##   #  ##  ##  #########   #   #########  ##  ##  ######  ##########  #############   #   #####  ##  ## 
##   #####  ##  #############   #   #   #####  ##  ##  ##  ##  #########   #   #########  ##  ##   #####  ##########  #############   #   #####   #  ## 
#########################   #   #   #   #   #########  ##  #####################   #   #  ##  ######  ##  ##  #   #####   #   #   #########  ########## 
#########################   #   #   #   #   #########  ##  #####################   #   #  ##   #####  ##  ##  ##  #####   #   #   #########  ########## 
##   ########   ##  #################   #################  ##  #   ##  #   #####################  ##  #############   #####   #####   #   #####   #  ## 
##   #########  #   #################   #################  ##  ##  #   #   #####################   #  #############   #####   #####   #   #####  ##  ## 
######  ##  #####################   #   #  ##  ##   #########  #############   #   #####  ##  ##########  #    #########  #####   #########  ##  ##  ## 
######  ##  #####################   #   #  ##   #   #########  #############   #   #####   #  ##########  ##  #########   #####   #########   #  ##  ## 
##  ##  ##  #####   #   #########   #####  #########   ##  ##  #####################   #####  ##   #################  #####   #########   #########  ## 
##  ##  ##  #####   ##  #########   #####  ##########  ##  ##  #####################   #####  ##  #################   #####   #########   #########  ## 
##  ##  ##  #####   ##  #   #   #############   #########  #########   #################  ######  ##   ########    #####  #####################  ##  ## 
##  ##  ##  #####   ##  #   #   #############  ##########  ##########  #################   #####  ##   #########  #####   #####################  ##  ## 
##  ##########  #############   #   #################  ##  ##  #   #########   #   #   #   ################################   #####################  ## 
##   ########   #############   #   #################  ##  #   ##  #########   #   #   #   ################################   #####################  ## 
##   #####  ######  #   #   #########   #  ##   #  ##  ##########  #   #   #   #   #   #####  #################   #####   ############################# 
##   #####  #####   ##  #   #########   #   #  ##   #   ########   ##  #   #   #   #   #####   ################   #####   ############################# 
############################################################################   ######################################################################## 
 ###########################################################################   ####################################################################### 